Adlam	Phonetic	Part of Speech	Definitions	Tags
ぃかうあ	dba	adverb	before; marks that something happens before affected verb	
いあ	la	verb	go	
いあえぎ	lapo	adverb	after; marks that something happens after affected verb	
いかえき	lp始i	number	seven	
いぎがき	lo胃i	pronoun	proximate demonstrative	
ぅあすぎ	maqo	noun (G4)	tree	
ぅかぉあ	ma	pronoun	1PAU	
ぅきぜかぅあ	mit始ma	noun (G2)	moon	
ぅぎすあ	moq始a	verb	swallow	
ぅぎすあぜあ	moq始ata	noun (G1/G2)	throat	
ぅぎすあぉあ	moq始aa	verb	emotional copula	
ぅぎずあ	moga	verb	shine	
うあぅあ	bama	noun (G2)	squirrel	
うあがあ	ba胃a	number	ten	
うき	bi	pronoun	interrogative pronoun (who, what, where, etc.)	
うきすぎ	biqo	number	three	
うぎこあ	bok始a	number	six	
えあぜぎ	pat始o	pronoun	creates reflexive pronouns from personal or demonstrative pronouns	
えかぜあ	pt始a	number	four	
えぎぜあ	pota	noun (G1/G2)	eye	
えあ	p始a	pronoun	1SG	
えあすかすぎ	p始aqqo	noun (G4)	hill	
えあすぎずあ	p始aq始oga	noun (G3)	grass	
えあぜかずあ	p始atga	noun (G3)	breakfast	
えかぜあ	p始ta	verb	cook (with heat)	
ぉあ	a	verb	idly move	
ぉあうぎ	abo	pronoun	1DU	
ぉあげぎずあ	anoga	noun (G3)	clay	
ぉあすあ	aqa	adverb	yet	
ぉかげぎぅあ	noma	noun (G2)	sun	
ぉきぜぎずき	itogi	noun (G5)	day	
ぉぎえき	op始i	pronoun	1PL	
ぉぎくき	oi	number	eight	
がかげき	胃ni	adverb	NEG; negates the following verb	
がかすあ	胃qa	number	one	
がきぜぎずあ	胃itoga	noun (G3)	vine	
がきぜき	胃it始i	number	first (ordinal)	
がぎぅあ	胃oma	noun (G2)	cat	
がぎじあ	胃o涩a	modifier	quiet	
がぎすき	胃oqi	pronoun	2PL	
くあ	a	verb	make	
くかじかすぎ	涩qo	noun (G4)	house	
くぎがあずあ	o胃aga	noun (G3)	rose	
げかすあ	nq始a	verb	walk	
げぎぜあぜあ	notata	noun (G1/G2)	heart	
げぎぜあぉあ	notaa	verb	equivalence copula	
こあぉかずあ	kaga	noun (G3)	berry	
こかぃき	kdi	pronoun	distal demonstrative	
こきいぎぅあ	kiloma	noun (G2)	small bird	
こきがぎぜあ	ki胃ota	noun (G1/G2)	head	
こきぜき	kiti	number	two	
こぎぅかずあ	komga	noun (G3)	window	
こぎうかぅあ	kobma	noun (G2)	dog	
こあ	k始a	verb	sit	
こあじあ	k始a涩a	adverb	so that; marks affected verb as purpose behind something else	
じあ	涩a	verb	eat (involves chewing)	
じあぉかぜあ	涩ata	noun (G1)	hand	
じあがあぅあ	涩a胃ama	noun (G2)	rain	
すあいかぜあ	qalta	noun (G1/G2)	mouth	
すあすぎぅあ	qaq始oma	noun (G2)	fish	
すき	qi	pronoun	2SG	
すきげかぅあ	qinma	noun (G2)	river	
すぎげあ	qona	pronoun	2DU	
すあがあ	q始a胃a	verb	speak	
すあがかぉぎずき	q始a胃ogi	noun (G5)	language	
すかえあぜあ	qp始ata	noun (G1/G2)	body	
すかえあぉあ	qp始aa	verb	existential copula	
すかぉあ	q始a	number	nine	
すぎぉあ	q始oa	pronoun	2PAU	
すぎすかぜあ	q始oqta	noun (G1)	face	
すぎすかぉあ	q始oqa	verb	property copula	
ずあぃあがあ	gada胃a	verb	arrange	
ずあぃあがぎじかいきずき	gada胃o涩ligi	noun (G5)	arrangement; grammar	
ずあがぎ	ga胃o	pronoun	3DU	
ずかぉあ	ga	pronoun	3PAU	
ずき	gi	pronoun	3SG	
ずぎすき	goqi	number	five	
ずぎずき	gogi	pronoun	3PL	
ずぎげあ	gona	modifier	still, calm	
ずぎげかえき	gonpi	noun (G5)	calmness	
ぜあ	ta	verb	throw (pottery)	
ぜかがぎずあ	t胃oga	noun (G3)	egg	
ぜあすあ	t始aqa	verb	wear (clothing)	
ぜあすかぅあ	t始aqma	noun (G2)	road/path	
ぜあぜあぅあ	t始atama	noun (G2)	snow	
ぜかがあぜあ	t始胃ata	noun (G1/G2)	foot	
ぜかがあぉあ	t始胃aa	verb	locational copula	
