Adlam	Phonetic	Part of Speech	Definitions	Tags
ぃかずぎ	d伞o	modifier (color)	red	
いかこきぜぎ	lkit始o	noun (G5)	noodle	
いぎぃきえか	lodip	noun (G5)	origin	
ぅきげかがあ	min胃a	noun (G5)	home	
ぅきげきうぎ	minibo	noun (G3)	dog	
ぅぎ	mo	noun (G1)	1SG pronoun (I, me)	
ぅぎぜかぉあ	mota	noun (G5)	marterial	
うかぃあ	bda	modifier (color)	white	
えきがぎ	pi胃o	modifier	necessary	
えぎぜかぅき	p始ot始mi	modifier	composed	
ぉかぜぎぜあ	t始ot始a	noun (G4)	letter	
がかげき	胃ni	adverb	not; negates the primary verb	
がかじあいき	胃涩ali	noun (G6)	yesterday	
げかずきぃ	n伞id-	verb	spoil	
こきぃぎう	kidob-	verb	bite	
こきぉぎがき	kio胃i	noun (G5)	clothing covering legs and chest and secured at the shoulders; overalls	
こきぜき	kiti	numeral	two	
こあぃぎぅ	k始adom-	verb	clarify	
こぎえ	k始op始-	verb	go	
すあぅかえぎ	qamp始o	noun (G5)	cheese	
すかがぎう	q胃ob-	verb	write	
ずぎくきえぎ	伞oipo	noun (G5)	forest	
ずぎくきえぎぜかすぎ	伞oipotq始o	modifier (color)	forest-green	
ぜあすぎ	taq始o	modifier (color)	black	
ぜあずぎじ	ta伞o涩-	verb	discuss	
ぜかすぎ	tq始o	modifier (color)	green/blue	
ぜぎくきぜき	toit始i	modifier	cultural	
ぜきがぎ	t始i胃o	modifier (color)	yellow	
