Adlam	Phonetic	Part of Speech	Definitions	Tags
いあじあげあ	la涩ana	adverb	today	
がかげき	胃ni	adverb	not; negates the primary verb	
こぎすきがぎ	k始oq始i胃o	adverb	evening	
ぜかうぎ	t始bo	adverb	additionally; backgrounds the modified verb compared to a matrix verb	
えきずき	pi伞i	incorporated noun	(by way of) vehicle	
ぃかずぎ	d伞o	modifier	red	color
うかぃあ	bda	modifier	white	color
えきえかこかいぎ	pip始klo	modifier	color of brown clay	color
えきがぎ	pi胃o	modifier	necessary	
えぎぜかぅき	p始ot始mi	modifier	composed	
くあぅあこあ	amaka	modifier	daily	
ずぎくきえぎぜかすぎ	伞oipotq始o	modifier	forest-green	color
ぜあすぎ	taq始o	modifier	black	color
ぜかすぎ	tq始o	modifier	green/blue	color
ぜかずかぜき	t伞t始i	modifier	favorite	
ぜぎくきぜき	toit始i	modifier	cultural	
ぜきがぎ	t始i胃o	modifier	yellow	color
ぅあうぎ	mabo	noun (G1)	we (dual); G1.1DU	pronoun
ぅぎ	mo	noun (G1)	I; G1.1SG	pronoun
うぎすかじき	boq始涩i	noun (G1)	partner; spouse	
ぅきげきうぎ	minibo	noun (G3)	dog	
ぉかぜぎぜあ	t始ot始a	noun (G4)	letter	
いかこきぜぎ	lkit始o	noun (G5)	noodle	
いぎぃきえか	lodip	noun (G5)	origin	
ぅきげかがあ	min胃a	noun (G5)	home	
ぅぎぜかぉあ	mota	noun (G5)	marterial	
えきえかいぎ	pip始lo	noun (G5)	brown clay	
こあいぎぉき	kaloi	noun (G5)	school	
こきぉぎがき	kio胃i	noun (G5)	clothing covering legs and chest and secured at the shoulders; overalls	
こかぃかすき	k始dq始i	noun (G5)	button-down shirt	
こぎぃかすあ	k始odq始a	noun (G5)	clothing; outfit	
すあぅかえぎ	qamp始o	noun (G5)	cheese	
ずぎくきえぎ	伞oipo	noun (G5)	forest	
ぜきぃぎ	t始ido	noun (G5)	it; G5.SG	pronoun
がかじあいき	胃涩ali	noun (G6)	yesterday	
ぜあうぎすき	t始aboqi	noun (G6)	walk, stroll	
こきぜき	kiti	numeral	two	
がかうあこ	胃bak始-	verb	wear	
げかずきぃ	n伞id-	verb	spoil	
こきぃぎう	kidob-	verb	bite	
こあぃぎぅ	k始adom-	verb	clarify	
こぎえ	k始op始-	verb	go	
すかがぎう	q胃ob-	verb	write	
ぜあずぎじ	ta伞o涩-	verb	discuss	
